####################
#H.................#
#....~~~~~.........#
#....~...~.....E...#
#....~.M.~.........#
#....~...~.........#
#....~~~~~..####...#
#............#.....#
#............#.....#
#..####......#.....#
#.....#............#
#.....#....~~~~~...#
#.....#....~...~...#
#.....#....~.E.~...#
#..........~...~...#
#..........~~~~~...#
#..................#
#.....M............#
#...............B..#
####################