20 20
####################
#H.....#...........#
#.....##.....M.....#
#.....#............#
#.....#..#######...#
#........#.....#...#
#..####..#..E..#...#
#..#.....#.....#...#
#..#.....#######...#
#..#................
#..#..TTTT.........#
#..#...............#
#..###########.....#
#..................#
#.....M............#
#..........####....#
#..........#..#....#
#.....E....#..#..B.#
#..........####....#
####################