20 20
####################
#H.................#
#....TTTT..........#
#....####......E...#
#.......#..........#
#.......#....#######
#.......#..........#
#..M....#..........#
#.......######.....#
#..................#
#.....TTTTT........#
#..................#
#..######..........#
#.......#..........#
#.......#.....M....#
#.......#..........#
#....E..#..........#
#.......########...#
#...............B..#
####################