WLOOLLLLWWLLLOOOWWLL
WWLOOOLLLWWLLOOOOWLW
OOWWLLLLOOOOOWWWWLWO
WLOOOOLLOOLLLLOOOOLL
LLOOWWLLLLLOOOWOWOWW
LLWOWLLWOOOOLOOOWOWW
WOOOOLLWOWWOOOOOOOWW
LLLOOOOOOOOOWWWLLLOW
WOWLOLWOLLOOOWLOOOOW
OLOOLWLOOOOOOOWWOWLL
WWLLOOLOOOWOOWLOOOLW
OWWOOOOOOWWOWOOOLOOW
WLWWLLLOOWLOOOWLLWLL
WOWOOOWWOLLOLOLLOOWW
WWLLWOWWOLOOWLOOLLLW
WWWOLOOWWWWLWLOOWOOW
OWOOWWWWOWLLLOWWOWLW
WOWOOOWLLLOLWLLLOWOW
LLWOLOLLOOWOWOLWWOOL
LWLWLOOOWLWLLWLOOOOW
